00000000
00001111
00012222
00122222
01222222
12222222