00000001
10000002
21001112
22112222
22222222
22222222