0000000000000000000000000000000000000000000000000000
1111111111111111111111111111111111111111111111111111
0004040000044000404000004400040400000440004040000044
4443434440433444343444043344434344404334443434440433
3332323334322333232333432233323233343223332323334322
2222222223222222222222322222222222232222222222223222