00000001
00000002
00011112
00122222
01222222
12222222