00000000
00000000
00001000
00001000
11111111
22222222