00000000
00000000
00040400
44434344
33323233
22222222