00000000
00000000
00000000
11110011
22221122
22222222