00000000000000000000
00000000440000000000
00004444330404000000
44443333224343404444
33332222223332343333
22222222222222232222