00000001
10000002
21011112
22122222
22222222
22222222