0000000000000000000000000000000000000000000000000000000000000000000000000000000
4444400444444000000004444400444444000000000000000000000000000000000000000000000
3333340333333004000043333340333333004000040000000000000000000000000000000000000
2222230444444043444432222220444444043444430000000000000000000000000000000000044
2222224333333432333332222224333333432333324444444444444444444444444444444444433
2222223222222332222222222223222222332222223333333333333333333333333333333333322
x