0000000000000000000000000000000000000000
0000000044000000000000000000440000000000
0000444433040400000000004444330404000000
4444333322434340444444443333224343404444
3333222222333234333333332222223332343333
2222222222222223222222222222222222232222