000000000000000000000000000000000000000000000000000000000000000000000000000000000000000000000000000000000000000000000000
000000000000000000000000000000000000000000000000000000000000000000000000000000000000000000000000000000000000000000000000
222222200000000000000000000000000000000000000000000000000000000000000000000000222222222222222222222000000000000000000000
222222222022222000000000000000000000000000000000000000000000000000000000000002222222222222222222200000000000000002220000
222222222022222200000000000000000000000000000000000000000000000000000000000022222222222222222220000000000000000000000000
222222222222222200000000000000000000000000000000000000000000000000000000002222222222222220000000000000000000000000000000
222222222222222220002222002200220020000000000000222200000000000000000000222222222222220000000000000000000000000000002222
222222222222222220000000000000000000020000000022222220000000000000000022222222222222200000000000000000000000000002222222
222222222222222220000000000000000000000000000222222222000000000222222222222222222222200222002220000000000000000222222222
222222222222222222000000000000000000000000002222222222200000002222222222222222222222200000000000000000000000002222222222
222222222222222222220000000000000000000000222222222222200000022222222222222222222222200000000000000000000002222222222222
222222222222222222222000000000000000000222222222222222222200222222222222222222222222222222222222222222222222222222222222
222222222222222222222222222222222222222222222222222222222222222222222222222222222222222222222222222222222222222222222222
222222222222222222222222222222222222222222222222222222222222222222222222222222222222222222222222222222222222222222222222
222222222222222222222222222222222222222222222222222222222222222222222222222222222222222222222222222222222222222222222222
x