0000000000000000000000000000000000000000000000000000000000000000000000000000000
0000000000000000000000000000000000000000000000000000000000000000000000000000000
2222200022222000000002222200222222000000000000000000000000000000000000000000000
2222202000000002000022222220000000002000020000000000000000000000000000000000000
2222202222222022222222222220222222022222220000000000000000000000000000000000022
2222222222222222222222222222222222222222222222222222222222222222222222222222222
x