00000000000000000000000000000000000000000000000000000
00000000000000000000000000000000000000000000000000000
22222000222220000000022222002222220000000000000000000
22222020000000020000222222200000000020000200000000000
22222022222220222222222222202222220222222200000000022
22222222222222222222222222222222222222222222222200222
22222222222222222222222222222222222222222222222222222
x