000000000000000000000000000000000000000000
444440044444400000000444440044444400000000
333334033333300400004333334033333300400004
222223044444404344443222222044444404344443
222222433333343233333222222433333343233332
222222322222233222222222222322222233222222
x