000000000000000000000000000000000000000000000000000000
000000000000000000000000000000020000000000000000000000
000000000000020000000000002200020000000000000000020000
220000002222222002200000002222222002200000002222222000
220000002222222022200000002222222022200000002222222022
222222222222222222222222222222222222222222222222222222
222222222222222222222222222222222222222222222222222222
222222222222222222222222222222222222222222222222222222
222222222222222222222222222222222222222222222222222222
x