000000000000000000000000000000000000000000000000000000
000000000000040000000000000000000000000000000000000000
440000000444434004400000000444434004400000000444434000
330000004333323043300000004333323043300000004333323044
224444443222222432244444443222222432244444443222222433
223333332222222322233333332222222322233333332222222322