0000000000000000000000000000000000000000
0000000000000000000000000000000000000000
0000000022000000000000000000220000000000
0000222222020200000000002222220202000000
2222222222222220222222222222222222202222
2222222222222222222222222222222222222222
x