000000000000000000000000000000000000000000000000000000000000000000000
000000000000000000000000000000000000000000000000000000000000000000000
000000000000000000000222200000000000000000000000000000000000000000000
000000000000000000002222200000000000000022222222200000000000000000000
000000000002220222222222220000200002220022222222200000000000000000000
000000000002220222222222222000200222220022000000000000000000000000000
000000000002220222222222222002222222220022000000000000000000000000000
000000000002220222222222222002222222220022000000222222200000000000000
000000000222222222222222222002222222220022000222222222222200000000000
000000000000000000000000000000000000000000000222222200222222200000000
222220000000000000000000000000000000000000000222200000000222222000000
222222000000000000000000222002222222220022222222000000000002222000000
222222222200000000002222222002222222220022222220000000000000000000000
222222222222022222222222200000000000000000000000000000000000000000000
222222222222022222222200000000000000000000000000000000000000000022222
222222222222000000000000000000000000000000000000000000000000000222222
222222222222000000000000000000000000000000000000000000000000222222222
222222222222222222222220022002200220022222002200220022002222222222222
222222222222222222222220022002200220022222002200220022002222222222222
222222222222222222222220022002200220022222002200220022002222222222222
x