000000000000000000000000000000000000000000000000000000000000000000000000000000000000000000000000000000000000000000000000
000000000000000000000000000000000000000000000000000000000000000000000000000000000000000000000000000000000000000000000000
000000022222222222222222222222222222222222222222222222222222222222222222222222222222222222222222222222222222222222222222
000000022222222222222222222222222222222222222222222222222222222222222222222222222222222222222222222222222222222222222222
000000022222222222222222222222222222222222222222222222222222222222222222222222222222222222222222222222222222222222222222
000000022222222222222222222222222222222222222222222222222222222222222222222222222222222222222222222222222222222222222222
000000022222222222222222222222222222222222222222222222222222222222222222222222222222222222222222222222222222222222222222
000000022222222222222222222222222222222222222222222222222222222222222222222222222222222222222222222222222222222222222222
000000022222222222222222222222222222222222222222222222222222222222222222222222222222222222222222222222222222222222222222
000000022222222222222222222222222222222222222222222222222222222222222222222222222222222222222222222222222222222222222222
000000022222222222222222222222222222222222222222222222222222222222222222222222222222222222222222222222222222222222222222
222222222222222222222222222222222222222222222222222222222222222222222222222222222222222222222222222222222222222222222222
222222222222222222222222222222222222222222222222222222222222222222222222222222222222222222222222222222222222222222222222
x